NO ./textures/no.png
SO ./textures/so.png
WE ./textures/we.png
EA ./textures/ea.png
F 0,30,0
C 225,30,255
X ./textures/sanic
D ./textures/door
        1111111111111111111111111
        1000000000000000000000001
        101100000001D100000000001
        100100000001D100000000001
11111111101100000111D100000000001
10000000001100000111D111111111111
111101111111110111X0N00010001
1111D111111111011101010010001
11000000110101011100000010001
1000000000000000110000000001
100X0000000000011D1010010001
1100000111010101111101111000111
11110111 1110101 101111010001
11111111 1111111 111111111111
