NO ./textures/no.png
SO ./textures/so.png
WE ./textures/we.png
EA ./textures/ea.png
C 225,30,0
F 220,30,0

1111111111111111111
1000001000000010001
1011111011101110101
1000000010101000101
1011111110101011101
1000000000100010001
1111101111101110111
1010001000100010001
1010111010111111101
1000101010001E00001
1011101011101011111
1010001010100010001
1011101010111110111
1010001010001000001
1010111010111011101
1010001010000010001
1011101111111110101
1000000000000000101
1111111111111111111
